10, 10, 1,

00,00,00,00,00,00,00,00,00,02,
04,01,01,01,01,01,01,01,01,02,
04,01,01,01,01,01,01,01,01,02,
04,01,01,01,01,01,01,01,01,02,
04,01,01,01,01,01,01,01,01,02,
04,01,01,01,01,01,01,01,01,02,
04,01,01,01,01,01,01,01,01,02,
04,01,01,01,01,01,01,01,01,02,
04,01,01,01,01,01,01,01,01,02,
04,03,03,03,03,03,03,03,03,03,